111111
1PEC01
111111
1C0001
111111
