111111111111111111111111111111111111111111111111111
1P001000000010C0C0001000000C0C0000001000100C1000001
111011111110101011101110111111111011101010101011101
10100C0000100010101000100000100C10000010001010C0101
10111111101C111010111011111010101111111011101110101
1000100000100010100010C0100010100000001CC0100000101
101110111110111010101110101110111111101011111111101
10100010100010001010100C1000101C00001010100000000C1
101011101011101110111011101110101010101010111111101
101000101010100010001010001C00101C1010101000001C001
1C1110101010111011101011111011101011101011111011101
101000101C00001000100000001010101000001010001C00101
101011101011111110111111101C1010111111111C101110101
1010100000100000100010001000101C10000000C0100000101
101010111110111010101110111110101011111111111111101
10001010001000101010001000001C100C100000000C0000101
101111101010101010111010111010111110111110111110101
10000000101010101C00101C1C0000000000100000100010101
1111111110111C1011111010101111111011111111101010101
1010000C00100010000000101010C00010100C1000101010101
1C1011111110111111111110111C1110111C101010101011101
101000000000101000001000C010001010001000100C1000001
101111111111101010111011101C11101011111111111111111
100000001000001010000010100C10001010000010000000001
101111101010111011111110111110111010111010101111101
100000101010100C10001000001010001000100C1C100010001
10111010101010111C101110101011101111101110111010111
1C101010001010100010000010000010000010C010001010101
10101011111110101111111111111C101111111011111010101
10C01000000C000010000000000C001000000000000000100E1
111111111111111111111111111111111111111111111111111