11111111111111111111111111111111111
1P000000000000000000C00000000000001
10111111101111111011101111110111001
10000000100000001000000000000001001
10111110101110101011111101111101001
10000010100000101000000001000101001
10111110101110101110111001110101001
10000000100000000000001000000100001
10111110101111111011101011101111101
10000000100000001000001000000000001
10101110101110101011101011111111001
10001000100000101000001000000001001
10111111101111101111101011111101001
10000000000000000000000000000001001
11111110111111111110111111111011001
1C0000000000000000000000000000C0001
10111111111111111111101111111111001
10000000000000000000000000000000001
10111111111111111111111111111111111
10000000000000000000000000000001E01
11111111111111111111111111111111111
