1111111111111111111111111111111111111111
1P000000000000000000000000C00000000C0001
1000000000000000000000C0000000000C0C0001
1011111111111111111111111111111111111101
1000000000000000000000000000000C00000001
1011111111111111111111111111111111111101
10C00000000C00C000000C00000000C000000001
1000000000000000000000000000000C00000001
1000000000000000000000000C0000C000000C01
100000000000000C0000000000C000000C0000C1
100C000000000000000000000000C00000000001
10000000000000000000C0000000000000000001
10000000C0000000000000000000000000000001
1011111111111111111111111111111111111111
10000000000000000000000000000C0000000001
100000000000000000000000000000000C000001
1000000000000000000000000000C00000000C01
100000000000000000000000000000000000CC01
100000000000000000000000C000000000000001
1111111111111111111111111111111111111111