1111111111111111111111111
1P0000000010C100000000001
1010111110111111101110101
1010000000100000100000101
1010111010111010101110101
1010001010000010100000101
1011111010111010111001111
1000000010000000000000001
1011111010111111101110111
1000000010000000100000101
1010111010111010101110101
1010000010000010100000101
1011111110111110111110101
1000000000000000000000E01
1111111111111111111111111