11111111111111111111111111
10P0000000C00000000000E001
11111111111111111111111111
